Pikachu	ELECTRIC	NONE
Raichu	ELECTRIC	NONE
Clefairy	FAIRY	NONE
Clefable	FAIRY	NONE
Vulpix	FIRE	NONE
Zubat	POISON	FLYING
Golbat	POISON	FLYING
Paras	BUG	GRASS
Parasect	BUG	GRASS
Psyduck	WATER	NONE
Golduck	WATER	NONE
Growlithe	FIRE	ROCK
Arcanine	FIRE	ROCK
Abra	PSYCHIC	NONE
Kadabra	PSYCHIC	NONE
Alakazam	PSYCHIC	NONE
Machop	FIGHTING	NONE
Machoke	FIGHTING	NONE
Machamp	FIGHTING	NONE
Tentacool	WATER	POISON
Tentacruel	WATER	POISON
Geodude	ROCK	GROUND
Graveler	ROCK	GROUND
Golem	ROCK	GROUND
Ponyta	FIRE	NONE
Rapidash	FIRE	NONE
Magnemite	ELECTRIC	STEEL
Magneton	ELECTRIC	STEEL
Gastly	GHOST	POISON
Haunter	GHOST	POISON
Gengar	GHOST	POISON
Onix	ROCK	GROUND
Voltorb	ELECTRIC	GRASS
Electrode	ELECTRIC	GRASS
Lickitung	NORMAL	NONE
Rhyhorn	GROUND	ROCK
Rhydon	GROUND	ROCK
Chansey	NORMAL	NONE
Tangela	GRASS	NONE
Mr. Mime	PSYCHIC	FAIRY
Scyther	BUG	FLYING
Electabuzz	ELECTRIC	NONE
Magmar	FIRE	NONE
Magikarp	WATER	NONE
Gyarados	WATER	FLYING
Eevee	NORMAL	NONE
Vaporeon	WATER	NONE
Jolteon	ELECTRIC	NONE
Flareon	FIRE	NONE
Porygon	NORMAL	NONE
Snorlax	NORMAL	NONE
Cyndaquil	FIRE	NONE
Quilava	FIRE	NONE
Typhlosion	FIRE	GHOST
Crobat	POISON	FLYING
Pichu	ELECTRIC	NONE
Cleffa	FAIRY	NONE
Togepi	FAIRY	NONE
Togetic	FAIRY	FLYING
Sudowoodo	ROCK	NONE
Aipom	NORMAL	NONE
Yanma	BUG	FLYING
Espeon	PSYCHIC	NONE
Umbreon	DARK	NONE
Murkrow	DARK	FLYING
Misdreavus	GHOST	NONE
Unown	PSYCHIC	NONE
Gligar	GROUND	FLYING
Steelix	STEEL	GROUND
Qwilfish	DARK	POISON
Scizor	BUG	STEEL
Heracross	BUG	FIGHTING
Teddiursa	NORMAL	NONE
Ursaring	NORMAL	NONE
Swinub	ICE	GROUND
Piloswine	ICE	GROUND
Remoraid	WATER	NONE
Octillery	WATER	NONE
Mantine	WATER	FLYING
Porygon2	NORMAL	NONE
Stantler	NORMAL	NONE
Elekid	ELECTRIC	NONE
Magby	FIRE	NONE
Blissey	NORMAL	NONE
Wurmple	BUG	NONE
Silcoon	BUG	NONE
Beautifly	BUG	FLYING
Cascoon	BUG	NONE
Dustox	BUG	POISON
Ralts	PSYCHIC	FAIRY
Kirlia	PSYCHIC	FAIRY
Gardevoir	PSYCHIC	FAIRY
Nosepass	ROCK	NONE
Roselia	GRASS	POISON
Barboach	WATER	GROUND
Whiscash	WATER	GROUND
Duskull	GHOST	NONE
Dusclops	GHOST	NONE
Chimecho	PSYCHIC	NONE
Snorunt	ICE	NONE
Glalie	ICE	NONE
Spheal	ICE	WATER
Sealeo	ICE	WATER
Walrein	ICE	WATER
Turtwig	GRASS	NONE
Grotle	GRASS	NONE
Torterra	GRASS	GROUND
Chimchar	FIRE	NONE
Monferno	FIRE	FIGHTING
Infernape	FIRE	FIGHTING
Piplup	WATER	NONE
Prinplup	WATER	NONE
Empoleon	WATER	STEEL
Starly	NORMAL	FLYING
Staravia	NORMAL	FLYING
Staraptor	NORMAL	FLYING
Bidoof	NORMAL	NONE
Bibarel	NORMAL	WATER
Kricketot	BUG	NONE
Kricketune	BUG	NONE
Shinx	ELECTRIC	NONE
Luxio	ELECTRIC	NONE
Luxray	ELECTRIC	NONE
Budew	GRASS	POISON
Roserade	GRASS	POISON
Cranidos	ROCK	NONE
Rampardos	ROCK	NONE
Shieldon	ROCK	STEEL
Bastiodon	ROCK	STEEL
Burmy	BUG	NONE
Wormadam	BUG	GRASS
Wormadam	BUG	GROUND
Wormadam	BUG	STEEL
Mothim	BUG	FLYING
Combee	BUG	FLYING
Vespiquen	BUG	FLYING
Pachirisu	ELECTRIC	NONE
Buizel	WATER	NONE
Floatzel	WATER	NONE
Cherubi	GRASS	NONE
Cherrim	GRASS	NONE
Shellos	WATER	NONE
Gastrodon	WATER	GROUND
Ambipom	NORMAL	NONE
Drifloon	GHOST	FLYING
Drifblim	GHOST	FLYING
Buneary	NORMAL	NONE
Lopunny	NORMAL	NONE
Mismagius	GHOST	NONE
Honchkrow	DARK	FLYING
Glameow	NORMAL	NONE
Purugly	NORMAL	NONE
Chingling	PSYCHIC	NONE
Stunky	POISON	DARK
Skuntank	POISON	DARK
Bronzor	STEEL	PSYCHIC
Bronzong	STEEL	PSYCHIC
Bonsly	ROCK	NONE
Mime Jr.	PSYCHIC	FAIRY
Happiny	NORMAL	NONE
Chatot	NORMAL	FLYING
Spiritomb	GHOST	DARK
Gible	DRAGON	GROUND
Gabite	DRAGON	GROUND
Garchomp	DRAGON	GROUND
Munchlax	NORMAL	NONE
Riolu	FIGHTING	NONE
Lucario	FIGHTING	STEEL
Hippopotas	GROUND	NONE
Hippowdon	GROUND	NONE
Skorupi	POISON	BUG
Drapion	POISON	DARK
Croagunk	POISON	FIGHTING
Toxicroak	POISON	FIGHTING
Carnivine	GRASS	NONE
Finneon	WATER	NONE
Lumineon	WATER	NONE
Mantyke	WATER	FLYING
Snover	GRASS	ICE
Abomasnow	GRASS	ICE
Weavile	DARK	ICE
Magnezone	ELECTRIC	STEEL
Lickilicky	NORMAL	NONE
Rhyperior	GROUND	ROCK
Tangrowth	GRASS	NONE
Electivire	ELECTRIC	NONE
Magmortar	FIRE	NONE
Togekiss	FAIRY	FLYING
Yanmega	BUG	FLYING
Leafeon	GRASS	NONE
Glaceon	ICE	NONE
Gliscor	GROUND	FLYING
Mamoswine	ICE	GROUND
Porygon-Z	NORMAL	NONE
Gallade	PSYCHIC	FIGHTING
Probopass	ROCK	STEEL
Dusknoir	GHOST	NONE
Froslass	ICE	GHOST
Rotom	ELECTRIC	GHOST
Rotom	ELECTRIC	FIRE
Rotom	ELECTRIC	WATER
Rotom	ELECTRIC	ICE
Rotom	ELECTRIC	FLYING
Rotom	ELECTRIC	GRASS
Uxie	PSYCHIC	NONE
Mesprit	PSYCHIC	NONE
Azelf	PSYCHIC	NONE
Dialga	STEEL	DRAGON
Palkia	WATER	DRAGON
Heatran	FIRE	STEEL
Regigigas	NORMAL	NONE
Giratina	GHOST	DRAGON
Cresselia	PSYCHIC	NONE
Phione	WATER	NONE
Manaphy	WATER	NONE
Darkrai	DARK	NONE
Shaymin	GRASS	NONE
Shaymin	GRASS	FLYING
Arceus	NORMAL	NONE
Oshawott	WATER	NONE
Dewott	WATER	NONE
Samurott	WATER	DARK
Petilil	GRASS	NONE
Lilligant	GRASS	FIGHTING
Basculin	WATER	NONE
Zorua	NORMAL	GHOST
Zoroark	NORMAL	GHOST
Rufflet	NORMAL	FLYING
Braviary	PSYCHIC	FLYING
Tornadus	FLYING	NONE
Thundurus	ELECTRIC	FLYING
Landorus	GROUND	FLYING
Alakazam	PSYCHIC	NONE
Gengar	GHOST	POISON
Gyarados	WATER	DARK
Steelix	STEEL	GROUND
Scizor	BUG	STEEL
Heracross	BUG	FIGHTING
Gardevoir	PSYCHIC	FAIRY
Glalie	ICE	NONE
Lopunny	NORMAL	FIGHTING
Garchomp	DRAGON	GROUND
Lucario	FIGHTING	STEEL
Abomasnow	GRASS	ICE
Gallade	PSYCHIC	FIGHTING
Sylveon	FAIRY	NONE
Goomy	DRAGON	NONE
Sliggoo	DRAGON	STEEL
Goodra	DRAGON	STEEL
Bergmite	ICE	NONE
Avalugg	ICE	ROCK
Pikachu	ELECTRIC	NONE
Raichu	ELECTRIC	PSYCHIC
Vulpix	ICE	NONE
Geodude	ROCK	ELECTRIC
Graveler	ROCK	ELECTRIC
Golem	ROCK	ELECTRIC
Eevee	NORMAL	NONE
Rowlet	GRASS	FLYING
Dartrix	GRASS	FLYING
Decidueye	GRASS	FIGHTING
Sneasel	FIGHTING	POISON
Sneasler	FIGHTING	POISON
Overqwil	DARK	POISON
Kleavor	BUG	ROCK
Ursaluna	NORMAL	GROUND
Wyrdeer	NORMAL	PSYCHIC
Basculegion	WATER	GHOST
Enamorus	FAIRY	FLYING
